+--+--+--+--+--+--+--+--+--+--+--+--+--+--+--+
S           |  |                       |     |
+  +--+--+  +  +  +--+--+--+--+--+--+  +--+  +
|  |     |  |  |        |              |     |
+  +  +  +  +  +--+--+  +  +--+--+--+--+  +  +
|  |  |  |     |        |     |           |  |
+  +  +  +--+--+  +  +--+--+  +  +--+--+--+  +
|  |  |           |  |     |  |     |     |  |
+  +  +--+--+--+--+  +  +  +  +--+  +  +--+  +
|     |     |        |  |  |  |     |  |     |
+--+--+  +  +  +--+--+  +--+  +  +--+  +  +--+
|        |     |     |     |     |     |     |
+  +--+--+--+--+--+  +--+  +--+--+  +--+  +  +
|           |        |        |  |  |     |  |
+  +--+--+--+  +--+--+  +--+  +  +  +--+--+  +
|  |        |  |     |  |  |  |              |
+  +--+  +  +  +  +  +  +  +  +--+  +--+--+--+
|     |  |     |  |  |  |           |  |     |
+--+  +  +--+--+  +  +  +--+  +--+--+  +  +  +
|     |  |        |  |     |     |        |  |
+  +  +  +  +--+--+--+--+  +--+  +  +--+--+  +
|  |  |  |  |  |           |  |     |        |
+  +--+  +  +  +  +  +--+--+  +--+--+  +--+  +
|     |  |        |        |           |     |
+--+  +  +--+--+--+--+--+  +--+--+--+--+  +  +
|  |     |        |        |     |     |  |  |
+  +--+--+  +--+  +  +--+--+  +  +  +  +  +  +
|        |  |  |     |     |  |     |     |  |
+  +--+  +  +  +--+--+  +  +  +--+--+--+--+  +
|     |     |           |     |              F
+--+--+--+--+--+--+--+--+--+--+--+--+--+--+--+