+--+--+--+--+--+--+--+--+--+--+--+--+--+--+--+
S     |        |           |              |  |
+  +  +--+--+  +--+--+--+  +  +--+--+--+  +  +
|  |        |  |        |  |  |        |     |
+--+--+--+  +  +  +--+  +  +  +--+--+  +  +--+
|           |     |        |  |        |     |
+  +--+--+--+--+--+  +  +--+  +  +--+--+--+--+
|     |           |  |  |     |  |           |
+  +  +--+  +--+  +--+  +  +--+  +  +--+--+  +
|  |     |  |     |     |     |  |     |     |
+  +--+  +  +  +  +  +--+--+  +  +--+  +--+  +
|     |     |  |     |     |  |  |  |  |     |
+--+  +--+--+--+--+--+--+  +  +  +  +  +  +--+
|     |           |     |  |           |  |  |
+  +--+  +--+  +--+  +  +  +--+  +  +--+  +  +
|        |           |  |        |     |     |
+--+--+--+  +--+--+--+  +--+--+--+--+  +--+--+
|  |        |           |     |        |     |
+  +  +  +--+  +--+--+--+  +  +  +--+--+  +  +
|  |  |     |              |     |        |  |
+  +  +--+  +--+--+--+--+  +--+--+--+--+  +  +
|     |  |     |           |     |     |  |  |
+--+--+  +--+  +  +--+--+  +  +  +  +  +--+  +
|        |     |        |     |     |     |  |
+  +--+  +  +--+--+--+--+--+--+--+--+--+  +  +
|  |     |     |        |                    |
+  +--+--+--+  +  +--+  +  +--+--+--+--+  +--+
|     |     |  |  |  |  |        |     |     |
+--+  +  +  +--+  +  +  +--+--+  +  +--+  +--+
|        |           |           |        |  F
+--+--+--+--+--+--+--+--+--+--+--+--+--+--+--+